NO files/first.xpm
SO files/second.xpm
WE files/third.xpm
EA files/forth.xpm

F 237,241,214
C 157,192,139

1111111111111111111111111
1000100000110000000000001
10N0100001110000000000001
100010000000000000000000111111111
111111111111100001110000000000001
100000000011000001110111111111111
11110111111111011100000010001
11110111111111011101010010001
11000000110101011100000010001
10000000000000001100000010001
10000000000000001101010010001
110000011101010111110111100111
11110111 1110101 101111010001
11111111 1111111 111111111111